#####...
S.###.#.
....#.#.
###...#.
#######.
....EE.G
